95 95 95 95 95 95 95 95 95 95 95 95 95 95 95 95 95 95 95 95 95 95 95 95 95 95 95 95 95 95 95 95 95 95 95 95 95 95 95 95 95 95 95 95 95 95 95 95 95 95 95 95 95 95 95 95 95 95 95 95 95 95 95 95 95 95 95 95 95 95 95 95 95 95 95 95 95 95 95 95 95 95 95 95 95 95 95 95 95 95 95 95
95 95 95 95 95 95 95 95 95 95 95 95 95 95 95 95 95 95 95 95 95 95 95 95 95 95 95 95 95 95 95 95 95 95 95 95 95 95 95 95 95 95 95 95 95 95 95 95 95 95 95 95 95 95 95 95 95 95 95 95 95 95 95 95 95 95 95 95 95 95 95 95 95 95 95 95 95 95 95 95 95 95 95 95 95 95 95 95 95 95 95 95
95 95 1 2 3 95 95 95 95 95 95 95 95 95 95 95 95 95 95 95 95 95 95 95 95 95 95 95 95 95 95 95 95 95 95 95 95 95 95 95 95 95 95 95 95 95 95 95 95 95 95 95 95 95 95 95 95 95 95 95 95 95 95 95 95 95 95 95 95 95 95 95 95 95 95 95 95 95 95 95 95 95 95 95 95 95 1 2 3 95 95 95
95 95 16 17 18 4 4 4 4 4 4 4 4 4 4 4 4 4 4 4 4 4 4 4 4 4 4 4 4 4 4 4 4 4 4 4 4 4 4 4 4 4 4 4 4 4 4 4 4 4 4 4 4 4 4 4 4 4 4 4 4 4 4 4 4 4 4 4 4 4 4 4 4 4 4 4 4 4 4 4 4 4 4 4 4 4 16 17 18 95 95 95
95 95 31 32 33 47 47 47 47 47 47 47 47 47 47 47 47 47 47 47 47 47 47 47 47 47 47 47 47 47 47 47 47 47 47 47 47 47 47 47 47 47 47 47 47 47 47 47 47 47 47 47 47 47 47 47 47 47 47 47 47 47 47 47 47 47 47 47 47 47 47 47 47 47 47 47 47 47 47 47 47 47 47 47 47 47 31 32 33 95 95 95
95 95 16 47 48 95 95 95 95 95 95 95 95 95 95 95 95 95 95 95 95 95 95 95 95 95 95 95 95 95 95 95 95 95 95 95 95 95 95 95 95 95 95 95 95 95 95 95 95 95 95 95 95 95 95 95 95 95 95 95 95 95 95 95 95 95 95 95 95 95 95 95 95 95 95 95 95 95 95 95 95 95 95 95 95 95 48 47 46 95 95 95
95 95 46 95 95 95 95 95 95 95 95 95 95 95 95 95 95 95 95 95 95 95 95 95 95 95 95 95 95 95 95 95 95 95 95 95 95 95 95 95 95 95 95 95 95 95 95 95 95 95 95 95 95 95 95 95 95 95 95 95 95 95 95 95 95 95 95 95 95 95 95 95 95 95 95 95 95 95 95 95 95 95 95 95 95 95 95 95 46 95 95 95
95 95 46 95 95 95 95 95 95 95 95 95 67 95 95 95 95 95 95 95 95 95 95 95 95 95 95 95 95 95 95 95 95 95 8 39 39 39 39 39 39 39 39 39 39 39 39 39 39 39 39 39 39 39 39 39 39 39 39 39 39 39 39 39 39 39 39 39 39 39 39 39 39 39 39 39 39 39 39 39 39 9 95 95 95 95 95 95 46 95 95 95
95 95 46 95 95 95 95 95 95 67 95 67 67 95 95 95 95 95 95 95 95 95 95 95 95 95 95 95 95 95 95 95 95 95 38 95 95 95 95 95 95 95 95 95 95 95 95 95 95 95 95 95 95 95 95 95 95 95 95 95 95 95 95 95 95 95 95 95 95 95 95 95 95 95 95 95 95 95 95 95 95 38 95 95 95 95 95 95 46 95 95 95
95 95 46 95 95 95 95 5 105 105 105 105 105 105 105 105 105 105 105 105 105 105 105 105 105 6 95 95 67 67 95 95 95 95 38 67 95 95 95 95 95 95 95 95 95 95 95 95 95 95 95 95 95 95 95 95 95 81 80 80 80 80 82 95 95 95 95 95 95 95 95 95 81 80 82 95 95 95 95 95 95 38 95 95 95 95 95 95 46 95 95 95
95 95 46 95 95 67 67 120 52 52 52 52 52 52 52 52 52 52 52 52 52 52 52 52 52 120 95 5 105 105 37 22 37 105 105 6 95 95 95 81 80 80 80 80 80 80 80 80 80 80 80 80 80 80 80 80 80 80 80 80 80 80 80 80 80 80 80 80 80 80 80 80 80 80 80 82 95 95 95 95 95 23 39 39 9 95 95 95 46 95 95 95
95 95 46 95 95 67 95 120 52 5 105 105 105 105 105 35 105 105 105 22 7 105 105 6 52 120 39 120 108 108 111 108 111 108 108 120 95 81 80 80 80 80 80 80 80 80 80 80 80 80 80 80 80 80 80 80 80 80 80 80 80 80 80 80 80 80 80 80 80 80 80 80 80 80 80 80 80 82 95 95 95 95 95 95 38 95 95 95 46 95 95 95
95 95 46 95 95 95 95 120 52 120 13 92 13 92 13 120 108 108 108 92 93 67 67 120 52 120 95 120 103 104 103 104 103 104 103 120 95 80 80 80 80 80 80 97 95 95 95 95 95 95 95 95 95 95 95 95 96 80 80 80 80 97 95 95 95 95 95 95 95 95 96 80 80 80 80 80 80 80 95 95 95 95 95 95 38 95 95 95 46 95 95 95
95 95 46 95 95 95 67 120 52 120 28 107 28 107 28 120 106 107 106 107 106 107 67 120 52 120 95 120 44 119 108 108 108 119 44 120 95 80 80 80 97 95 95 95 95 95 95 95 95 95 95 95 95 95 95 95 95 96 80 80 80 95 95 95 95 95 95 95 95 95 95 95 96 80 80 80 80 97 95 95 95 95 95 95 38 95 95 95 46 95 95 95
95 95 46 95 95 95 95 120 52 120 91 92 91 92 91 61 91 92 91 92 91 92 91 120 52 120 95 120 59 104 103 104 103 104 59 120 95 80 80 97 95 95 95 95 95 95 95 95 95 95 95 95 95 95 95 95 95 95 80 80 97 95 95 95 95 95 95 95 95 95 95 95 95 95 95 95 95 95 95 95 95 95 95 95 38 95 95 95 46 95 95 95
95 95 46 95 95 95 95 120 52 120 13 107 13 107 13 120 106 107 106 107 106 107 106 120 52 120 95 120 118 119 118 119 118 119 118 120 95 80 80 95 95 95 95 95 95 95 95 95 95 95 95 95 95 95 95 95 95 95 80 80 95 95 95 95 95 95 95 95 95 95 95 95 5 105 105 105 105 105 105 105 105 105 105 105 105 6 95 95 46 95 95 95
95 95 46 95 95 95 95 120 52 120 28 92 28 92 28 120 91 92 91 92 91 92 91 120 52 120 95 120 108 108 6 79 5 108 108 120 95 80 80 95 5 105 105 105 105 105 105 105 105 105 105 105 105 105 6 95 95 95 80 80 95 95 95 5 105 105 105 105 105 35 61 35 21 52 52 52 52 52 52 52 52 52 52 52 52 120 95 95 46 95 95 95
95 95 46 95 95 95 95 120 52 20 105 105 105 105 105 36 105 105 105 105 6 78 5 21 52 120 95 20 105 105 36 62 36 105 105 21 95 80 80 95 120 52 52 52 52 52 52 52 52 52 52 52 52 52 20 105 105 6 53 53 5 105 105 21 52 52 52 52 52 120 76 120 52 52 5 105 51 35 105 51 35 105 51 6 52 120 95 95 46 95 95 95
95 95 46 95 95 8 39 120 52 52 52 52 52 52 52 52 52 52 52 52 120 76 120 52 52 120 95 95 95 95 81 80 95 95 95 95 95 80 80 95 120 52 5 105 7 105 7 22 7 105 7 105 6 52 5 105 105 36 63 63 36 105 105 6 52 5 7 105 105 21 76 20 6 52 120 12 84 120 12 84 120 12 84 120 52 120 95 95 46 95 95 95
95 95 46 95 95 38 95 20 105 105 105 105 105 105 105 105 105 105 105 105 36 61 36 105 105 21 95 95 95 95 81 80 82 95 95 95 95 80 80 95 120 52 120 40 94 42 94 40 94 42 94 40 120 52 120 40 41 42 43 40 41 42 43 120 52 120 93 108 108 76 76 76 120 52 120 27 84 120 27 84 120 27 84 120 52 120 95 95 46 95 95 95
95 95 46 95 95 38 81 80 80 80 82 95 95 95 95 95 95 95 95 95 81 80 82 95 95 95 95 95 95 81 80 80 80 82 95 95 80 80 80 95 120 52 120 55 56 57 58 55 56 57 58 55 120 52 120 55 56 57 58 55 56 57 58 120 52 120 76 76 76 76 76 76 120 52 120 84 84 120 84 84 120 84 84 120 52 120 95 95 46 95 95 95
95 95 46 95 95 63 80 80 80 80 80 80 80 82 95 95 95 95 81 80 80 80 80 82 95 95 95 81 80 80 80 80 80 80 80 80 80 80 80 95 120 52 120 70 71 72 73 70 71 72 73 70 120 52 20 105 105 6 53 53 5 105 105 21 52 34 105 50 105 45 45 45 120 52 34 98 66 36 98 66 36 98 66 19 52 120 95 95 46 95 95 95
95 95 46 95 95 38 97 95 95 95 96 80 80 80 80 80 80 80 80 80 80 80 80 80 80 80 80 80 80 80 80 80 80 80 80 80 80 80 97 95 120 52 120 74 86 87 88 85 86 87 88 83 120 52 52 52 52 34 61 61 19 52 52 52 52 120 76 76 76 76 76 76 120 52 120 84 84 84 84 84 84 84 84 120 52 120 95 95 46 95 95 95
95 95 46 95 95 38 95 95 95 95 95 95 96 80 80 80 80 80 80 80 80 80 80 80 80 80 80 80 80 80 80 80 80 80 80 97 95 95 95 95 120 52 120 89 41 42 43 40 41 42 43 89 120 52 5 105 105 21 42 43 20 105 105 6 52 120 76 76 76 76 76 76 120 52 120 84 84 84 84 84 84 84 84 120 52 120 95 95 46 95 95 95
95 95 46 95 95 38 95 95 95 95 95 95 95 96 80 80 80 80 80 80 80 80 80 80 80 80 80 80 80 80 80 80 97 95 5 105 105 105 105 105 21 52 20 105 105 105 35 79 35 105 105 105 21 52 120 58 55 56 57 58 55 56 57 120 52 20 105 105 6 76 5 105 21 52 20 105 105 105 6 79 5 105 105 21 52 120 95 95 46 95 95 95
95 95 46 95 95 38 95 95 95 95 95 95 95 95 80 80 80 80 80 80 80 80 80 80 80 80 80 80 80 80 97 95 95 95 120 52 52 52 52 52 52 52 52 52 52 52 120 53 120 52 52 52 52 52 120 73 70 71 72 73 70 71 72 120 52 52 52 52 34 66 19 52 52 52 52 52 52 52 34 66 19 52 52 52 52 120 95 95 46 95 95 95
95 95 46 95 95 38 95 95 95 95 95 95 95 95 96 80 80 80 97 95 95 95 95 95 95 95 95 95 95 95 95 95 95 95 120 52 5 105 105 105 105 105 105 105 105 105 36 62 36 105 105 105 6 52 120 88 85 86 87 88 85 86 87 120 52 5 105 105 21 86 20 105 105 105 105 105 105 105 21 88 20 6 52 5 105 21 95 95 46 95 95 95
95 95 46 95 95 38 95 95 95 95 95 95 95 95 95 80 80 97 95 95 95 95 95 95 95 95 95 95 95 95 95 95 95 95 120 52 120 41 42 43 40 41 42 43 40 41 42 43 40 41 42 43 20 22 21 43 40 41 42 43 40 41 42 20 22 21 42 43 40 41 42 43 40 41 42 43 40 41 42 43 40 120 52 120 95 95 95 95 46 95 95 95
95 95 46 95 95 38 95 95 95 95 95 95 95 95 95 80 80 95 5 105 105 105 105 105 105 105 105 105 105 105 105 105 105 105 21 52 120 56 57 58 55 56 57 58 55 56 57 58 55 56 57 58 55 56 57 58 55 56 57 58 55 56 57 58 55 56 57 58 55 56 57 58 55 56 57 58 55 56 57 58 55 120 52 120 95 95 95 95 46 95 95 95
95 95 46 95 95 38 95 95 95 95 95 95 95 95 95 80 80 95 120 52 52 52 52 52 52 52 52 52 52 52 52 52 52 52 52 52 120 71 72 73 70 71 72 73 70 71 72 73 70 71 72 73 70 71 72 73 70 71 72 73 70 71 72 73 70 71 72 73 70 71 72 73 70 71 72 73 70 71 72 73 70 120 52 120 95 95 95 95 46 95 95 95
95 95 46 95 95 38 95 95 95 95 95 95 95 95 95 80 80 95 120 52 5 105 105 105 105 105 105 105 105 105 105 105 105 105 6 52 120 86 87 88 85 86 87 88 85 86 87 88 85 86 87 88 85 86 87 88 85 86 87 88 85 86 87 88 85 86 87 88 85 86 87 88 85 86 87 88 85 86 87 88 85 120 52 120 82 95 95 95 46 95 95 95
95 95 46 95 95 38 95 95 95 95 95 95 95 95 81 80 80 95 120 52 120 114 100 101 100 101 100 101 100 101 100 101 100 114 120 52 120 41 42 43 40 5 105 62 105 105 35 66 98 98 98 35 66 98 98 98 6 41 42 43 40 5 66 98 98 98 35 66 98 98 98 35 66 98 98 98 6 41 42 43 40 34 105 19 80 82 95 95 46 95 95 95
95 95 46 95 95 38 95 95 95 95 95 95 95 95 80 80 80 95 120 52 120 114 115 116 115 116 115 116 115 116 115 116 115 114 120 52 120 56 57 58 55 120 103 104 103 104 120 40 41 42 43 120 40 41 42 43 120 56 57 58 55 120 40 41 42 43 120 40 41 42 43 120 40 41 42 43 120 56 57 58 55 61 84 63 80 80 82 95 46 95 95 95
95 95 46 95 95 38 95 95 95 95 95 95 95 95 96 80 80 95 120 52 120 114 100 114 5 6 114 101 114 5 6 114 100 101 20 105 21 71 72 73 70 120 108 108 118 119 120 67 56 57 10 120 67 56 57 10 120 71 72 73 70 120 67 56 57 10 120 67 56 57 11 120 67 56 57 10 120 71 72 73 70 34 105 19 80 80 80 95 46 95 95 95
95 95 46 95 95 38 95 95 95 95 95 95 95 95 95 80 80 95 120 52 120 114 115 114 120 120 114 116 114 120 120 114 115 116 115 79 85 86 87 88 85 120 103 104 104 67 120 70 71 72 25 120 70 71 72 25 120 86 87 88 85 120 70 71 72 25 120 70 71 72 26 120 70 71 72 25 120 86 87 88 85 120 52 120 96 80 80 82 46 95 95 95
95 95 46 95 95 38 95 95 95 95 95 95 95 95 95 80 80 95 120 52 120 114 100 114 20 21 114 101 114 20 21 114 100 101 5 105 6 41 42 43 40 34 105 105 105 105 36 105 105 105 105 36 105 105 105 35 21 41 42 43 40 20 35 105 105 105 36 105 105 105 105 36 105 105 105 105 19 41 42 43 40 120 52 120 95 80 80 80 46 95 95 95
95 95 46 95 95 38 95 95 95 95 95 95 95 95 95 80 80 95 120 52 120 114 115 116 115 116 115 116 115 116 115 116 115 114 120 52 120 56 57 58 55 120 69 54 69 69 69 69 69 69 69 69 69 69 69 65 55 56 57 58 55 56 65 69 69 69 69 69 69 69 69 69 69 54 69 68 120 56 57 58 55 120 52 120 95 96 80 80 46 95 95 95
95 95 46 95 95 38 95 95 95 95 95 95 95 95 95 80 80 95 120 52 120 114 100 101 100 101 100 101 100 101 100 101 100 114 120 52 120 71 72 73 70 34 105 105 105 105 35 105 105 105 105 35 105 105 105 36 6 71 72 73 70 5 36 105 105 105 35 105 105 105 105 35 105 105 105 105 19 71 72 73 70 120 52 120 95 95 80 80 46 95 95 95
95 95 46 95 95 38 95 95 95 95 95 95 95 95 81 80 80 95 120 52 20 105 105 105 105 105 105 105 105 105 105 105 105 105 21 52 120 86 87 88 85 120 10 56 57 58 120 10 56 57 58 120 10 56 57 58 120 86 87 88 85 120 10 40 40 40 120 10 40 40 40 120 10 56 57 84 120 86 87 88 85 120 52 120 95 95 96 80 46 95 95 95
95 95 46 95 95 38 95 95 95 95 95 95 95 81 80 80 80 95 120 52 52 52 52 52 52 52 52 52 52 52 52 52 52 52 52 52 120 41 42 43 40 120 25 71 72 67 120 25 71 72 67 120 25 71 72 67 120 41 42 43 40 120 25 40 40 67 120 25 40 40 67 120 25 71 72 67 120 41 42 43 40 120 52 120 95 95 95 96 46 95 95 95
95 95 46 95 95 38 95 95 95 95 95 95 81 80 80 80 80 95 20 6 52 5 105 105 105 105 105 105 105 105 105 105 105 105 6 52 120 56 57 58 55 120 85 86 87 88 120 85 86 87 88 120 85 86 87 88 120 56 57 58 55 120 85 86 87 88 120 85 86 87 88 120 85 86 87 88 120 56 57 58 55 120 52 120 95 95 95 95 46 95 95 95
95 95 46 95 95 38 95 95 95 95 81 80 80 80 80 80 80 95 95 120 52 120 103 104 103 104 103 104 103 104 103 104 103 104 120 52 120 71 72 73 70 20 98 98 98 66 36 98 98 98 66 36 98 98 98 66 21 71 72 73 70 20 98 98 98 66 36 98 98 98 66 36 98 98 98 66 21 71 72 73 70 120 52 120 95 95 95 95 46 95 95 95
95 95 46 95 95 38 95 95 81 80 80 80 80 80 80 80 80 95 95 120 52 120 118 119 109 109 109 119 118 109 109 109 118 119 120 52 120 86 87 88 85 86 87 88 85 86 87 88 85 86 87 88 85 86 87 88 85 86 87 88 85 86 87 88 85 86 87 88 85 86 87 88 85 86 87 88 85 86 87 88 85 120 52 120 95 95 95 95 46 95 95 95
95 95 46 95 95 38 95 95 80 80 80 80 80 80 80 80 97 95 67 120 52 120 103 104 108 108 108 104 103 108 108 108 103 104 120 52 120 41 42 43 40 41 42 43 40 41 42 43 40 41 42 43 40 41 42 43 40 41 42 43 40 41 42 43 40 41 42 43 40 41 42 43 40 41 42 43 40 41 42 43 40 120 52 120 95 95 95 95 46 95 95 95
95 95 46 95 95 38 95 81 80 80 80 80 80 80 80 80 95 95 95 120 52 120 118 119 109 109 109 119 118 109 109 109 118 119 20 105 21 56 57 58 55 56 57 58 55 56 57 58 55 56 57 58 55 56 57 58 55 56 57 58 55 56 57 58 55 56 57 58 55 56 57 58 55 56 57 58 55 56 57 58 55 120 52 120 95 95 95 95 46 95 95 95
95 95 46 95 95 38 95 80 80 80 80 80 80 80 80 80 82 95 95 120 52 120 103 104 103 104 103 104 103 104 103 104 103 104 103 79 70 71 72 73 70 71 72 73 70 71 72 73 70 71 72 73 70 71 72 73 70 71 72 73 70 71 72 73 70 71 72 73 70 71 72 73 70 71 72 73 70 71 72 73 70 120 52 120 95 95 95 95 46 95 95 95
95 95 46 95 95 38 95 80 80 80 80 80 80 80 80 80 80 95 95 120 52 120 118 119 118 119 118 119 118 109 109 109 118 119 5 105 6 86 87 88 85 5 105 62 105 105 35 66 98 98 98 35 66 98 98 98 6 86 87 88 85 5 66 98 98 98 35 66 98 98 98 35 66 98 98 98 6 86 87 88 85 120 52 120 95 95 95 95 46 95 95 95
95 95 46 95 95 38 95 80 80 80 80 80 80 80 80 80 80 95 95 120 52 120 103 104 108 108 108 104 103 108 108 108 103 104 120 52 120 41 42 43 40 120 103 104 103 104 120 40 41 42 43 120 40 41 42 43 120 41 42 43 40 120 40 41 42 43 120 40 41 42 43 120 40 41 42 43 120 41 42 43 40 120 52 120 95 95 95 95 46 95 95 95
95 95 46 95 95 38 95 80 80 80 80 80 80 80 80 80 80 82 95 120 52 120 118 119 109 109 109 119 118 109 109 109 118 119 120 52 120 56 57 58 55 120 108 108 118 119 120 67 56 57 10 120 67 56 57 10 120 56 57 58 55 120 67 56 57 10 120 67 56 57 10 120 67 56 57 10 120 56 57 58 55 120 52 120 95 95 95 95 46 95 95 95
95 95 46 95 95 38 95 96 80 80 80 80 80 80 80 80 80 80 95 120 52 120 103 104 103 104 103 104 103 104 103 104 103 104 120 52 120 71 72 73 70 120 103 104 104 67 120 70 71 72 25 120 70 71 72 25 120 71 72 73 70 120 70 71 72 25 120 70 71 72 25 120 70 71 72 25 120 71 72 73 70 120 52 120 95 95 95 95 46 95 95 95
95 95 46 95 95 38 95 95 95 95 95 95 96 80 80 80 80 80 95 120 52 120 118 119 118 119 118 119 118 119 118 119 118 119 120 52 120 86 87 88 85 34 105 105 105 105 36 105 105 105 105 36 105 105 105 35 21 86 87 88 85 20 35 105 105 105 36 105 105 105 105 36 105 105 105 105 19 86 87 88 85 120 52 120 95 95 95 95 46 95 95 95
95 95 46 95 95 38 95 95 95 95 95 95 95 96 80 80 80 80 95 120 52 20 105 105 6 90 90 90 90 90 90 75 5 105 21 52 120 41 42 43 40 120 69 54 69 69 69 69 69 69 69 69 69 69 69 65 40 41 42 43 40 41 65 69 69 69 69 69 69 69 69 69 69 54 69 68 120 41 42 43 40 120 52 120 95 95 95 95 46 95 95 95
95 95 46 95 95 38 95 67 67 95 95 95 95 95 95 96 80 80 95 120 52 52 52 52 120 118 118 118 118 118 118 119 120 52 52 52 120 56 57 58 55 34 105 105 105 105 35 105 105 105 105 35 105 105 105 36 6 56 57 58 55 5 36 105 105 105 35 105 105 105 105 35 105 105 105 105 19 56 57 58 55 120 52 120 95 95 95 95 46 95 95 95
95 95 46 95 95 38 95 67 5 105 105 105 105 105 6 95 80 80 95 20 105 105 6 52 34 62 105 7 22 7 105 7 36 7 6 52 120 71 72 73 70 120 10 56 57 84 120 10 56 57 84 120 10 56 57 84 120 71 72 73 70 120 10 40 40 40 120 10 40 40 40 120 10 56 57 58 120 71 72 73 70 120 52 120 95 95 95 95 46 95 95 95
95 95 46 95 95 38 95 95 120 67 41 42 43 40 120 95 80 80 95 95 95 95 120 52 120 104 103 93 103 93 103 93 103 93 120 52 120 86 87 88 85 120 25 71 72 67 120 25 71 72 67 120 25 71 72 67 120 86 87 88 85 120 25 40 40 67 120 25 40 40 67 120 25 71 72 67 120 86 87 88 85 120 52 120 95 95 95 95 46 95 95 95
95 95 46 95 95 23 39 39 120 55 56 57 58 55 120 81 80 80 82 95 95 95 120 52 120 119 118 119 118 119 118 119 118 119 120 52 120 41 42 43 40 120 85 86 87 88 120 85 86 87 88 120 85 86 87 88 120 41 42 43 40 120 85 86 87 88 120 85 86 87 88 120 85 86 87 88 120 41 42 43 40 120 52 120 95 95 95 95 46 95 95 95
95 95 46 95 95 95 95 95 120 70 71 72 73 70 61 80 80 80 80 95 95 95 120 52 120 104 103 104 103 104 103 104 103 74 120 52 120 56 57 58 55 20 98 98 98 66 36 98 98 98 66 36 98 98 98 66 21 56 57 58 55 20 98 98 98 66 36 98 98 98 66 36 98 98 98 66 21 56 57 58 55 120 52 120 95 95 95 95 46 95 95 95
95 95 46 95 95 95 95 95 120 85 86 87 88 85 120 96 80 80 80 95 95 5 21 52 120 119 118 108 108 108 118 119 118 89 20 105 21 71 72 73 70 71 72 73 70 71 72 73 70 71 72 73 70 71 72 73 70 71 72 73 70 71 72 73 70 71 72 73 70 71 72 73 70 71 72 73 70 71 72 73 70 120 52 120 95 95 95 95 46 95 95 95
95 95 46 95 95 95 95 5 7 105 61 105 6 40 120 95 80 80 80 95 95 20 105 105 21 104 103 104 103 104 103 104 103 104 79 62 85 86 87 88 85 86 87 88 85 86 87 88 85 86 87 88 85 86 87 88 85 86 87 88 85 86 87 88 85 86 87 88 85 86 87 88 85 86 87 88 85 86 87 88 85 120 52 120 95 95 95 95 46 95 95 95
95 95 46 95 95 95 95 120 93 41 42 43 120 55 120 95 80 80 80 95 95 62 103 79 118 119 118 108 108 108 118 119 118 83 5 105 6 41 42 43 40 41 42 43 40 41 42 43 40 41 42 43 40 41 42 43 40 41 42 43 40 41 42 43 40 41 42 43 40 41 42 43 40 41 42 43 40 41 42 43 84 120 52 120 95 95 95 95 46 95 95 95
95 95 46 95 95 95 95 120 55 56 57 58 34 105 21 95 80 80 80 95 95 5 105 105 6 104 103 104 103 104 103 104 103 89 120 52 120 56 57 58 55 56 57 58 55 56 57 58 55 56 57 58 55 56 57 58 55 56 57 58 55 56 57 58 55 56 57 58 55 56 57 58 55 56 57 58 55 56 57 58 55 120 52 120 95 95 95 95 46 95 95 95
95 95 46 95 95 95 95 120 67 71 72 73 120 95 95 95 80 80 80 95 95 20 6 52 20 105 105 105 105 105 105 105 105 105 21 52 20 105 105 105 105 105 105 105 105 105 6 53 53 53 5 105 105 105 105 105 105 105 105 105 105 105 105 105 105 105 105 105 105 105 6 73 5 105 105 105 105 105 105 105 105 21 52 120 95 95 95 95 46 95 95 95
95 95 46 95 95 95 95 120 67 67 87 113 120 95 95 95 80 80 80 95 95 95 120 52 52 52 52 52 52 52 52 52 52 52 52 52 52 52 52 52 52 52 52 52 52 52 120 41 42 43 120 52 52 52 52 52 52 52 52 52 52 52 52 52 52 52 52 52 52 52 34 66 19 52 52 52 52 52 52 52 52 52 52 120 95 95 95 95 46 95 95 95
95 95 46 95 95 95 95 20 105 105 105 105 21 95 95 95 80 80 80 95 95 95 20 105 105 105 105 105 105 6 52 5 105 105 105 105 105 105 105 22 105 105 105 105 6 52 120 56 57 58 120 52 5 105 105 22 105 105 105 105 105 22 105 105 6 52 52 5 105 105 21 76 20 105 105 105 105 6 52 5 105 105 105 21 95 95 95 95 46 95 95 95
95 95 46 95 95 95 95 95 95 38 95 95 95 95 95 95 80 80 80 95 95 95 95 95 95 95 95 95 67 120 52 120 40 15 42 15 40 15 42 43 40 41 42 43 120 52 120 71 72 73 120 52 120 104 103 104 103 104 103 104 103 104 103 104 120 52 52 120 60 60 76 76 76 60 60 60 60 120 52 120 95 95 95 95 95 95 95 95 46 95 95 95
95 95 46 95 95 95 95 95 95 38 95 95 95 95 95 95 80 80 80 82 95 95 95 95 95 95 95 95 95 120 52 120 55 30 57 30 55 30 57 58 55 56 57 58 20 105 21 86 87 88 120 52 120 119 111 112 111 112 111 112 111 112 111 112 120 52 52 120 76 76 76 91 92 76 76 76 76 120 52 120 95 95 95 95 95 95 95 95 46 95 95 95
95 95 46 95 67 95 95 95 67 38 95 95 95 95 95 95 80 80 80 80 95 95 95 95 95 95 95 95 95 120 52 120 70 71 72 73 70 71 72 73 70 71 72 73 84 79 40 41 42 43 120 52 120 104 103 104 103 104 103 104 103 104 103 104 120 52 52 120 76 76 76 106 107 76 76 76 76 120 52 120 95 95 95 95 95 95 95 95 46 95 95 95
95 95 46 105 105 105 105 105 105 105 6 95 95 95 95 81 80 80 80 80 82 95 95 95 95 95 95 95 95 120 52 120 85 86 87 88 85 86 87 88 5 7 45 45 35 105 6 56 57 58 20 105 21 119 111 112 111 112 111 112 111 112 111 112 120 52 52 120 60 60 76 76 76 60 60 60 60 120 52 120 95 95 95 95 95 95 95 95 46 95 95 95
95 95 46 52 52 52 52 52 52 52 120 95 95 95 95 80 80 80 80 80 80 82 95 95 95 95 95 95 95 120 52 120 40 15 42 15 40 15 42 43 20 93 76 76 120 52 120 71 72 73 70 79 103 104 103 104 103 104 103 104 103 104 103 104 120 52 52 120 76 76 76 76 76 76 76 76 76 120 52 120 95 95 95 95 95 95 95 95 46 95 95 95
95 95 46 52 5 105 105 7 6 52 120 95 95 95 81 80 80 80 80 80 80 80 82 95 95 95 95 95 95 120 52 120 55 30 57 30 55 30 57 58 61 76 76 113 120 52 120 86 87 88 5 105 6 119 99 119 99 119 99 119 99 119 99 119 120 52 52 20 105 105 35 62 35 105 105 105 105 21 52 120 95 95 95 95 95 95 95 95 46 95 95 95
95 95 46 52 120 67 67 93 120 52 120 95 95 95 80 80 80 80 80 80 80 80 80 95 95 95 95 95 95 120 52 34 105 105 105 105 105 105 105 35 105 105 105 105 21 52 120 41 42 43 120 52 120 104 103 104 103 104 103 104 103 104 103 104 120 52 52 52 5 7 21 76 120 52 52 52 52 52 52 120 95 95 95 95 95 95 95 95 46 95 95 95
95 95 46 52 120 40 41 42 120 52 120 95 95 81 80 80 80 80 80 80 80 80 80 82 95 95 95 95 95 120 52 120 54 69 69 69 69 69 69 120 52 52 52 52 52 52 120 56 57 58 120 52 120 119 99 119 99 119 99 119 99 119 99 119 120 52 52 52 120 93 108 76 120 52 5 105 105 105 105 21 95 95 95 95 95 95 95 95 46 95 95 95
95 95 46 52 120 55 56 57 20 105 19 81 80 80 80 80 80 80 80 80 80 80 80 80 82 95 95 95 95 20 105 36 105 105 105 105 105 105 105 36 105 105 105 105 6 52 120 71 72 73 120 52 120 104 103 104 103 104 103 104 103 104 103 104 120 52 52 52 120 76 76 76 120 52 120 95 95 95 95 95 95 95 95 95 95 95 95 95 46 95 95 95
95 95 46 52 120 67 71 72 73 70 66 80 80 80 80 80 80 80 80 80 80 80 80 80 80 80 82 95 95 95 95 95 95 95 95 95 95 81 80 80 80 80 82 95 120 52 120 86 87 88 120 52 20 105 105 105 105 105 105 105 105 105 105 105 21 52 52 52 20 105 105 105 21 52 120 95 95 95 95 95 95 95 95 95 95 95 95 95 46 95 95 95
95 95 46 52 120 67 67 87 88 85 66 80 80 80 80 80 80 80 80 80 80 80 80 80 80 80 80 80 80 80 80 80 80 80 80 80 80 80 80 80 80 80 80 95 120 52 20 6 79 5 21 52 52 52 52 52 52 52 52 52 52 52 52 52 52 52 52 52 52 52 52 52 52 52 120 95 95 95 95 95 95 95 95 95 95 95 95 95 46 95 95 95
95 95 46 52 20 105 105 105 105 105 19 96 80 80 80 80 80 80 80 80 80 80 97 95 95 96 80 80 80 80 97 95 95 95 95 96 80 80 80 97 96 80 80 95 20 105 105 36 63 36 105 105 105 105 105 105 105 105 105 105 105 105 105 105 105 105 105 105 105 105 105 105 105 105 21 95 95 95 8 39 39 39 39 39 61 39 39 39 46 95 95 95
95 95 46 52 52 52 52 52 52 52 120 95 80 80 80 80 80 80 80 80 97 95 95 5 105 105 61 105 105 6 95 95 95 5 105 105 105 62 105 105 6 96 80 82 95 38 80 80 97 95 95 96 80 80 80 80 97 95 95 95 95 95 95 95 38 95 95 95 95 95 95 95 95 95 95 95 95 95 38 95 95 95 95 95 95 95 95 95 46 95 95 95
95 95 46 105 105 105 105 105 105 105 21 95 96 80 80 80 80 80 97 95 95 95 95 120 91 92 91 92 91 120 95 95 95 120 14 104 103 104 103 44 120 95 80 80 80 63 80 97 95 95 95 95 95 96 80 97 95 95 95 95 95 95 95 95 61 95 95 95 95 95 95 95 95 95 95 95 95 95 38 95 95 95 95 95 95 95 95 95 46 95 95 95
95 95 46 67 95 67 67 95 38 67 95 95 95 80 80 80 80 97 95 95 95 95 95 120 106 77 106 77 106 120 95 95 95 120 29 119 108 108 118 59 120 95 96 80 97 38 80 95 95 95 95 95 95 95 95 95 95 95 95 95 95 95 95 95 38 95 95 95 95 95 95 95 81 80 80 80 80 82 38 95 95 95 95 95 95 95 95 95 46 95 95 95
95 95 46 67 95 95 95 95 38 95 95 95 95 80 80 80 80 95 95 95 95 95 95 34 45 45 45 45 45 19 95 95 95 120 103 104 103 104 103 104 120 95 95 95 95 38 97 95 95 95 95 95 95 95 95 95 95 95 95 95 95 95 95 95 38 39 39 39 39 39 39 39 39 39 39 39 39 39 24 80 82 95 95 95 95 95 95 95 46 95 95 95
95 95 46 95 95 95 95 95 38 95 95 95 95 80 80 80 97 95 95 95 95 95 95 120 91 77 91 77 91 120 95 95 95 120 108 108 118 119 108 108 120 95 95 95 95 38 95 95 95 95 95 95 95 95 95 95 95 95 95 95 95 95 95 95 38 95 95 95 95 95 95 80 80 80 80 80 80 80 80 80 80 82 95 95 95 95 95 95 46 95 95 95
95 95 46 95 95 95 95 95 38 95 95 95 95 80 80 97 95 95 95 95 95 95 95 120 106 107 106 107 106 120 67 95 95 20 105 105 105 105 105 105 21 95 95 95 95 38 95 95 95 95 95 95 95 95 95 95 95 95 95 95 95 95 95 95 38 95 95 95 95 95 95 96 80 80 80 80 80 80 80 80 80 80 95 95 95 95 95 95 46 95 95 95
95 95 46 95 95 95 95 95 38 95 95 95 95 80 80 95 95 95 95 95 95 95 95 20 105 6 91 5 105 21 67 67 95 95 95 95 95 95 95 95 95 95 95 95 95 38 95 95 95 95 95 95 95 95 95 95 95 95 95 95 95 95 95 95 38 95 95 95 95 95 95 95 96 80 80 80 80 80 80 80 80 97 95 95 95 95 95 67 46 95 95 95
95 95 46 95 95 95 95 95 23 61 39 3 95 80 80 95 1 39 63 39 39 39 39 39 39 21 61 20 39 39 39 39 39 39 39 39 39 39 39 39 39 39 39 39 39 39 39 39 39 39 39 39 39 39 39 39 39 39 39 39 39 39 39 39 24 95 95 95 95 95 95 95 95 96 80 80 80 80 80 97 95 95 95 95 95 95 95 67 46 95 95 95
95 95 46 95 95 95 95 95 95 95 95 18 95 80 80 95 16 95 95 95 95 95 95 95 95 95 95 95 95 95 95 95 95 95 95 95 95 95 95 95 95 95 95 95 95 95 95 95 95 95 95 95 95 95 95 95 95 95 95 95 95 95 95 95 95 95 95 95 95 95 95 95 95 95 95 95 96 80 97 95 95 95 95 95 95 95 95 95 46 95 95 95
95 95 1 2 3 95 95 95 95 95 95 18 95 80 80 95 16 95 95 95 95 95 95 95 95 95 95 95 95 95 95 95 95 95 95 95 95 95 95 95 95 95 95 95 95 95 95 95 95 95 95 95 95 95 95 95 95 95 95 95 95 95 95 95 95 95 95 95 95 95 95 95 95 95 95 95 95 95 95 95 95 95 95 95 95 95 1 2 3 95 95 95
95 95 16 17 18 4 4 4 4 4 4 33 39 39 39 64 31 4 4 4 4 4 4 4 4 4 4 4 4 4 4 4 4 4 4 4 4 4 4 4 4 4 4 4 4 4 4 4 4 4 4 4 4 4 4 4 4 4 4 4 4 4 4 4 4 4 4 4 4 4 4 4 4 4 4 4 4 4 4 4 4 4 4 4 4 4 16 17 18 95 95 95
95 95 31 32 33 47 47 47 47 47 47 48 95 80 80 95 48 47 47 47 47 47 47 47 47 47 47 47 47 47 47 47 47 47 47 47 47 47 47 47 47 47 47 47 47 47 47 47 47 47 47 47 47 47 47 47 47 47 47 47 47 47 47 47 47 47 47 47 47 47 47 47 47 47 47 47 47 47 47 47 47 47 47 47 47 47 31 32 33 95 95 95
95 95 48 47 48 95 95 95 95 95 95 95 95 80 80 95 95 95 95 95 95 95 95 95 95 95 95 95 95 95 95 95 95 95 95 95 95 95 95 95 95 95 95 95 95 95 95 95 95 95 95 95 95 95 95 95 95 95 95 95 95 95 95 95 95 95 95 95 95 95 95 95 95 95 95 95 95 95 95 95 95 95 95 95 95 95 48 47 48 95 95 95
95 95 95 95 95 95 95 95 95 95 95 95 95 80 80 95 95 95 95 95 95 95 95 95 95 95 95 95 95 95 95 95 95 95 95 95 95 95 95 95 95 95 95 95 95 95 95 95 95 95 95 95 95 95 95 95 95 95 95 95 95 95 95 95 95 95 95 95 95 95 95 95 95 95 95 95 95 95 95 95 95 95 95 95 95 95 95 95 95 95 95 95
95 95 95 95 95 95 95 95 95 95 95 95 81 80 80 82 95 95 95 95 95 95 95 95 95 95 95 95 95 95 95 81 80 80 80 80 80 80 80 80 80 80 80 80 80 80 82 95 95 95 95 95 95 95 95 95 95 95 95 95 95 95 95 95 95 95 95 95 95 95 95 95 95 95 95 95 95 95 95 95 95 95 95 95 95 95 95 95 95 95 95 95
80 80 80 80 80 80 80 80 80 80 80 80 80 80 80 80 80 80 80 80 80 80 80 80 80 80 80 80 80 80 80 80 80 80 80 80 80 80 80 80 80 80 80 80 80 80 80 80 80 80 80 80 80 80 80 80 80 80 80 80 80 80 80 80 80 80 80 80 80 80 80 80 80 80 80 80 80 80 80 80 80 80 80 80 80 80 80 80 80 80 80 80
80 80 80 80 80 80 80 80 80 80 80 80 80 80 80 80 80 80 80 80 80 80 80 80 80 80 80 80 80 80 80 80 80 80 80 80 80 80 80 80 80 80 80 80 80 80 80 80 80 80 80 80 80 80 80 80 80 80 80 80 80 80 80 80 80 80 80 80 80 80 80 80 80 80 80 80 80 80 80 80 80 80 80 80 80 80 80 80 80 80 80 80